NO ./textures/eagle.xpm
SO ./textures/greystone.xpm
WE ./textures/red.xpm
EA ./textures/purplestone.xpm

F 220,100,0
C 225,30,0

111111
100001
1100W1
100001
111111
