NO ./textures/eagle.xpm
SO ./textures/greystone.xpm
WE ./textures/red.xpm
EA ./textures/purplestone.xpm

F 220,100,0
C 225,30,0

		1111111111111111111111111
		1000000000110000000000001
		1011000001110000000000001
		1001000000000000000000001
111111111011000001110000000000001
10E000000011000001110111111111111
11110111111111011100000020004
11110111111111011101010020004
11000000110101011100000020004
10000000000000001100000020004
10000000000000001101010020004
11000001110101011111011120N0411
11110111 1110101 101111020004
11111111 1111111 111111133333
