NO ./textures/eagle.xpm
SO ./textures/greystone.xpm
WE ./textures/red.xpm
EA ./textures/purplestone.xpm

F 220,100,0
C 225,30,0

1000000000000000000000000000N
10000000000000000000000000001
1100000111010101111101111000111
11110111 1110101 101111010001
11111111 1111111 111111111111
