NO ./map/textures/eagle.xpm
SO ./map/textures/greystone.xpm
WE ./map/textures/red.xpm
EA ./map/textures/purplestone.xpm

F 220,100,0
C 225,30,0

10000000000000000000000000000
100000000000N0000000000000001
1100000111010101111101111000111
11110111 1110101 101111010001
11111111 1111111 111111111111
